0000000000000000000000000000000000000000000000000000000000000000000000000000000000000000000000000000000000000000000000000000000000000000000000000000000000000000
0000000000000000000000000000000000000000000000000000000000000000000000000000000000000000000000000000000000000000000000000000000000000000000000000000000000000000
0000000000000000000000000000000000000000000000000000000000000000000000000000000000000000000000000000000000000000000000000000000000000000000000000000000000000000
0000000000000000000000000000000000000000000000000000000000000000000000000000000000000000000000000000000000000000000000000000000000000000000000000000000000000000
0000000000000000000000000000000000000000000000000000000000000000000000000000000000000000000000000000000000000000000000000000000000000000000000000000000000000000
0000000000000000000000000000000000000000000000000000000000000000000000000000000000000000000000000000000000000000000000000000000000000000000000000000000000000000
0000000000000000000000000000000000000000000000000000000000000000000000000000000000000000000000000000000000000000000000000000000000000000000000000000000000000000
0000000000000000000000000000000000000000000000000000000000000000000000000000000000000000000000000000000000000000000000000000000000000000000000000000000000000000
0000000000000000000000000000000000000000000000000000000000000000000000000000000000000000000000000000000000000000000000000000000000000000000000000000000000000000
0000000000000000000000000000000000000000000000000000000000000000000000000000000000000000000000000000000000000000000000000000000000000000000000000000000000000000
0000000000000000000000000000000000000000000000000000000000000000000000000000000000000000000000000000000000000000000000000000000000000000000000000000000000000000
0000000000000000000000000000000000000000000000000000000000000000000000000000000000000000000000000000000000000000000000000000000000000000000000000000000000000000
0000000000000000000000000000000000000000000000000000000000000000000000000000000000000000000000000000000000000000000000000000000000000000000000000000000000000000
0000000000000000000000000000000000000000000000000000000000000000000000000000000000000000000000000000000000000000000000000000000000000000000000000000000000000000
0000000000000000000000000000000000000000000000000000000000000000000000000000000000000000000000000000000000000000000000000000000000000000000000000000000000000000
0000000000000000000000000000000000000000000000000000000000000000000000000000000000000000000000000000000000000000000000000000000000000000000000000000000000000000
0000000000000000000000000000000000000000000000000000000000000000000000000000000000000000000000000000000000000000000000000000000000000000000000000000000000000000
0000000000000000000000000000000000000000000000000000000000000000000000000000000000000000000000000000000000000000000000000000000000000000000000000000000000000000
0000000000000000000000000000000000000000000000000000000000000000000000000000000000000000000000000000000000000000000000000000000000000000000000000000000000000000
0000000000000000000000000000000000000000000000000000000000000000000000000000000000000000000000000000000000000000000000000000000000000000000000000000000000000000
0000000000000000000000000000000000000000000000000000000000000000000000000000000000000000000000000000000000000000000000000000000000000000000000000000000000000000
0000000000000000000000000000000000000000000000000000000000000000000001000000000000000000010000000000000000000000000000000000000000000000000000000000000000000000
0000000000000000000000000000000000000000000000000000000000000000000000000000000000000000000000044444444444444444444000000000000000000000000000000000000000000000
0000000000000000000000000000000000000000000000000000000000000000000000000000000000000000000000044444444444444444444000000000000000000000000000000000000000000000
0000000000000000000000000000000000000000000000000000000000000000000000000000000000000000000000044444444444444444444000000000000000000000000000000000000000000000
0000000000000000000000000000000000000000000000000000000000000000000000000000000000000000000000044444444444444444444000000000000000000000000000000000000000000000
0000000000000000000000000000000000000000000000000000066666666666660000000000000000000000000000044444444444444444444000000000000000000000000000000000000000000000
0000000000000000000000000000000000000000000000000000066666666666660000000000000000000000000000044444444444444444444000000000000000000000000000000000000000000000
0000000000000000000000000000000000000000000000000000066666666666660000000000000000000000000000044444444444444444444000000000000000000000000000000000000000000000
0000000000000000000000000000000000000000000000000000066666666666660000000000000000000000000000044444444444444444444000000000000000000000000000000000000000000000
0000000000000000000000000000000000000000000000000000066666666666660000000000000000000000000000044444444444444444444000000000000000000000000000000000000000000000
0000000000000000000000000000000000000000000000000000066666666666660001000000000000000000010000044444444444444444444000000000000000000000000000000000000000000000
0000000000000000000000000000000000000000000000000000066666666666660000000000000000000000000000044444444444444444444000000000000000000000000000000000000000000000
0000000000000000000000000000000000000000000000000000066666666666660000000000000000000000000000044444444444444444444000000000000000000000000000000000000000000000
0000000000000000000000000000000000000000000000000000066666666666660000000000000000000000000000044444444444444444444000000000000000000000000000000000000000000000
0000000000000000000000000000000000000000000000000000066666666666660000000000000000000000000000044444444444444444444000000000000000000000000000000000000000000000
0000000000000000000000000000000000000000000000000000066666666666660000000000000000000000000000044444444444444444444000000000000000000000000000000000000000000000
0000000000000000000000000000000000000000000000000000066666666666660000000000000000000000000000044444444444444444444000000000000000000000000000000000000000000000
0000000000000000000000000000000000000000000000000000066666666666660000000000000000000000000000044444444444444444444000000000000000000000000000000000000000000000
0000000000000000000000000000000000000000000000000000066666666666660000000000000000000000000000044444444444444444444000000000000000000000000000000000000000000000
0000000000000000000000000000000000000000000000000000066666666666660000000000000000000000000000044444444444444444444000000000000000000000000000000000000000000000
0000000000000000000000000000000000000000000000000000066666666666660001000000000000000000010000044444444444444444444000000000000000000000000000000000000000000000
0000000000000000000000000000000000000000000000000000066666666666660000000000000000000000000000000000000000000000000000000000000000000000000000000000000000000000
0000000000000000000000000000000000000000000000000000066666666666660000000000000000000000000000777777777777777777777700999999999999999999999900000000000000000000
0000000000000000000000000000000000000000000000000000066666666666660000000000000000000000000000777777777777777777777700999999999999999999999900000000000000000000
0000000000000000000000000000000000000000000000000000066666666666660000000000000000000000000000777777777777777777777700999999999999999999999900000000000000000000
0000000000000000000000000000000000000000000000000000066666666666660000000000000000000000000000777777777777777777777700999999999999999999999900000000000000000000
0000000000000000000000000000000000000000000000000000066666666666660000000000000000000000000000777777777777777777777700999999999999999999999900000000000000000000
0000000000000000000000000000000000000000000000000000066666666666660000000000000000000000000000777777777777777777777700999999999999999999999900000000000000000000
0000000000000000000000000000000000000000000000000000066666666666660000000000000000000000000000777777777777777777777700999999999999999999999900000000000000000000
0000000000000000000000000000000000000000000000000000066666666666660000000000000000000000000000777777777777777777777700999999999999999999999900000000000000000000
0000000000000000000000000000000000000000000000000000066666666666660001000000000000000000010000777777777777777777777700999999999999999999999900000000000000000000
0000000000000000000000000000000000000000999999999999999966666666660000000000000000000000000000777777777777777777777700999999999999999999999900000000000000000000
0000000000000000000000000000000000000000999999999999999966666666660000000000000000000000000000777777777777777777777700999999999999999999999900000000000000000000
0000000000000000000000000000000000000000999999999999999966666666660000000000000000000000000000777777777777777777777700999999999999999999999900000000000000000000
0000000000000000000000000000000000000000999999999999999966666666660000000000000000000000000000777777777777777777777700999999999999999999999900000000000000000000
0000000000000000000000000000000000000000999999999999999900000000000000000000000001100000000000777777777777777777777700999999999999999999999900000000000000000000
0000000000000000000000000000000444444440999999999999999903333330000000000000000001100000000000777777777777777777777700999999999999999999999900000000000000000000
0000000000000000000000000000000444444440999999999999999903333330000000000000000001100000000000777777777777777777777700999999999999999999999900000000000000000000
0000000000000000000000000000000444444440999999999999999903333330000000000000000001100000000000777777777777777777777700999999999999999999999900000000000000000000
0000000000000000000000000000000444444440999999999999999903333330000000000000000001100000000000777777777777777777777700999999999999999999999900000000000000000000
0000000000000000000000000000000444444440999999999999999903333330000001000000000000000000010000777777777777777777777700999999999999999999999900000000000000000000
0000000000000000000000000000000444444440999999999999999903333330000000000000000000000000000000777777777777777777777700999999999999999999999900000000000000000000
0000000000000000000000000000000000000000000000000000000000000000000000000000000000000000000000777777777777777777777700999999999999999999999900000000000000000000
0000000000000000000000000000000000000000000000000000000000H00000000000000000000000000000000000777777777777777777777700999999999999999999999900000000000000000000
0000000000000000000000000000000000H0000000000H000000000000000000000000000000000000000000000000000000000000000000000000000000000000000000000000000000000000000000
0000000000000000000000000000000000000H000000000000H0000000000000000000000000000000000000000000000000000000000000000000000000000000000000000000000000000000000000
0000000000000000000000000000000000000000000000H00000000000000000000000000000000000000000000000000000000000000000000000000000000000000000000000000000000000000000
000000000000000000000000000000000000000000000000000000000000H000000000000000000000000000000000000000000000000000000000000000000000000000000000000000000000000000
0000000000000000000001000000000100000000010000000001000000000100000000000000000000000000000000000100000000010000000001000000000100000000010000000000000000000000
0000000000000000000000000000000000000000000000000000000000000000000000000000000000000000000000000000000000000000000000000000000000000000000000000000000000000000
0000000000000000000000000000000000000000000000000000000000000000000000000000000000000000000000000000000111111111100000000000000000000000000000000000000000000000
0000000000000000000000000000000000000000000000000000000111111000000000000000000000000000000000000000000111111111100000000000000000000000000000000000000000000000
0000000000000000000000000000000000000000000000000000000111111000000000000000000000000000000000000000000111111111100000000000000000000000000000000000000000000000
0000000000000000000000000000000000000000000000000000000000000000000000000000000000000000000000000000000000000000000000000000000000000000000000000000000000000000
0000000000000000000000000000000000000000000000000000000000000000000000000000000000000000000000000000000000000000000000000000000000000000000000000000000000000000
0000000000000000000000000000000000000000000000000000000000000000000000000011111100000000000000000000000000000000000000000000000000000000000000000000000000000000
0000000000000000000000000000000000000000000000000000000000000000000000000011111100000000000000000000000000000000000000000000000000000000000000000000000000000000
0000000000000000000000000000000000000000000000000000000000000000000000000011111100000000000000000000000000000000000000000000000000000000000000000000000000000000
C000000000000000000000000000000000000000000000000000000000000000000000000011111100000000000000000000000000000000000000000000000000000000000000000000000000000000
0000000000000000000000000000000000000000000000000000000000000000000000000011111100000000000000000000000111111111111111000000000000000000000000000000000000000000
0000000000000000000000000000000001111000111111000000000000000000000000000000000000000000000000000001111111111111111111000000000000000000000000000000000000000000
0000000000000000000000000000000001111000111111000000000000000000000000000000000000000000000000000001111111111111111111000000000000000000000000000000000000000000
0000000000000000000000000000000000000000111111000000000000000000000000000000000000000000000000000000000111111111111111000000000000000000000000000000000000000000
0000000000000000000000000000000000000000000000000000000000000000000000000000000000000000000000000000000000000000000000000000000000000000000000000000000000000000
0000000000000000000000000000000000000000000000000000000000000000000000000000000000000000000000000000000000000000000000000000000000000000000000000000000000000000
0000000000000000000000000000000000000000000000000000000000000000000000000000000000000000000000000000000000000000000000000000000000000000000000000000000000000000
0000000000000000000000000000000000000000000000000000000000000000000000000000000000000000000000000000000000000000000000000000000000000000000000000000000000000000
0000000000000000000000000000000000000000000000000000000000000000000000000000000000000000000000000000000000000000000000000000000000000000000000000000000000000000
0000000000000000000001000000000100000000010000000001000000000100000000000000000000000000000000000100000000010000000001000000000100000000010000000000000000000000
000000000000000000000000000000000000000000000000000000000000000000000000000000000000000000000000000H000000000000000000000000000000000000000000000000000000000000
0000000000000000000000000000000000000H0000000000000000H0000000000000000000000000000000000000000000000000000000000H0000000000000000000000000000000000000000000000
00000000000000000000000000000000000000000000H00000H0000000000000000000000000000000000000000000000000000000H00000000000000000000000H00000000000000000000000000000
0000000000000000000000000000000000000000000000000000000000000000000000000000000000000000000000000000000000000000000000000000000000000000000000000000000000000000
0000000000000000000000000000006666666666666666666600555555555555500000000000000000000000000000555555555555555000000000000000000000000000000000000000000000000000
0000000000000000000000000000006666666666666666666600555555555555500000000000000000000000000000555555555555555000000000888888888888880000000000000000000000000000
0000000000000000000000000000006666666666666666666600555555555555500000000000000000000000000000555555555555555000000000888888888888880000000000000000000000000000
0000000000000000000000000000006666666666666666666600555555555555500001000000000000000000010000555555555555555000000000888888888888880000000000000000000000000000
0000000000000000000000000000006666666666666666666600555555555555500000000000000000000000000000555555555555555000000000888888888888880000000000000000000000000000
0000000000000000000000000000006666666666666666666600555555555555500000000000000000000000000000555555555555555000000000888888888888880000000000000000000000000000
0000000000000000000000000000006666666666666666666600555555555555500000000000000000000000000000555555555555555000000000888888888888880000000000000000000000000000
0000000000000000000000000000006666666666666666666600555555555555500000000000000000000000000000555555555555555000000000888888888888880000000000000000000000000000
0000000000000000000000000000006666666666666666666600555555555555500000000000000000000000000000555555555555555000000000888888888888880000000000000000000000000000
0000000000000000000000000000006666666666666666666600555555555555500000000000000000000000000000555555555555555000000000888888888888880000000000000000000000000000
0000000000000000000000000000006666666666666666666600555555555555500000000000000000000000000000555555555555555000000000888888888888880000000000000000000000000000
0000000000000000000000000000006666666666666666666600555555555555500000000000000000000000000000555555555555555000000000888888888888880000000000000000000000000000
0000000000000000000000000000006666666666666666666600555555555555500000000000000000000000000000555555555555555000000000888888888888880000000000000000000000000000
0000000000000000000000000000006666666666666666666600555555555555500001000000000000000000010000555555555555555000000000888888888888880000000000000000000000000000
0000000000000000000000000000006666666666666666666600555555555555500000000000000000000000000000555555555555555000000000888888888888880000000000000000000000000000
0000000000000000000000000000006666666666666666666600555555555555500000000000000000000000000000555555555555555000000000000000000000000000000000000000000000000000
0000000000000000000000000000006666666666666666666600555555555555500000000000000000000000000000555555555555555000000000000000000000000000000000000000000000000000
0000000000000000000000000000006666666666666666666600555555555555500000000000000000000000000000555555555555555000000000000000000000000000000000000000000000000000
0000000000000000000000000000006666666666666666666600555555555555500000000000000000000000000000555555555555555000000000000000000000000000000000000000000000000000
0000000000000000000000000000006666666666666666666600555555555555500000000000000000000000000000555555555555555000000000000000000000000000000000000000000000000000
0000000000000000000000000000006666666666666666666600555555555555500000000000000000000000000000555555555555555000000000000000000000000000000000000000000000000000
0000000000000000000000000000000000000000000000000000555555555555500000000000000000000000000000555555555555555000000000000000000000000000000000000000000000000000
0000000000000000000000000000000000000000000000000000555555555555500000000000000000000000000000555555555555555000000000000000000000000000000000000000000000000000
0000000000000000000000000000000000000000000000000000555555555555500001000000000000000000010000555555555555555000000000000000000000000000000000000000000000000000
0000000000000000000000000000000000000000000000000000555555555555500000000000000000000000000000555555555555555000000000000000000000000000000000000000000000000000
0000000000000000000000000000000000000000000000000000555555555555500000000000000000000000000000555555555555555000000000000000000000000000000000000000000000000000
0000000000000000000000000000000000000000000000000000555555555555500000000000000000000000000000555555555555555000000000000000000000000000000000000000000000000000
0000000000000000000000000000000000000000000000000000555555555555500000000000000000000000000000555555555555555000000000000000000000000000000000000000000000000000
0000000000000000000000000000000000000000000000000000555555555555500000000000000000000000000000555555555555555000000000000000000000000000000000000000000000000000
0000000000000000000000000000000000000000000000000000555555555555500000000000000000000000000000555555555555555000000000000000000000000000000000000000000000000000
0000000000000000000000000000000000000000000000000000555555555555500000000000000000000000000000555555555555555000000000000000000000000000000000000000000000000000
0000000000000000000000000000000000000000000000000000555555555555500000000000000000000000000000555555555555555000000000000000000000000000000000000000000000000000
0000000000000000000000000000000000000000000000000000000000000000000000000000000000000000000000555555555555555000000000000000000000000000000000000000000000000000
0000000000000000000000000000000000000000000000000000000000000000000001000000000000000000010000555555555555555000000000000000000000000000000000000000000000000000
0000000000000000000000000000000000000000000000000000000000000000000000000000000000000000000000555555555555555000000000000000000000000000000000000000000000000000
0000000000000000000000000000000000000000000000000000000000000000000000000000000000000000000000555555555555555000000000000000000000000000000000000000000000000000
0000000000000000000000000000000000000000000000000000000000000000000000000000000000000000000000555555555555555000000000000000000000000000000000000000000000000000
0000000000000000000000000000000000000000000000000000000000000000000000000000000000000000000000555555555555555000000000000000000000000000000000000000000000000000
0000000000000000000000000000000000000000000000000000000000000000000000000000000000000000000000555555555555555000000000000000000000000000000000000000000000000000
0000000000000000000000000000000000000000000000000000000000000000000000000000000000000000000000555555555555555000000000000000000000000000000000000000000000000000
0000000000000000000000000000000000000000000000000000000000000000000000000000000000000000000000555555555555555000000000000000000000000000000000000000000000000000
0000000000000000000000000000000000000000000000000000000000000000000000000000000000000000000000555555555555555000000000000000000000000000000000000000000000000000
0000000000000000000000000000000000000000000000000000000000000000000000000000000000000000000000555555555555555000000000000000000000000000000000000000000000000000
0000000000000000000000000000000000000000000000000000000000000000000001000000000000000000010000555555555555555000000000000000000000000000000000000000000000000000
0000000000000000000000000000000000000000000000000000000000000000000000000000000000000000000000555555555555555000000000000000000000000000000000000000000000000000
0000000000000000000000000000000000000000000000000000000000000000000000000000000000000000000000555555555555555000000000000000000000000000000000000000000000000000
0000000000000000000000000000000000000000000000000000000000000000000000000000000000000000000000555555555555555000000000000000000000000000000000000000000000000000
0000000000000000000000000000000000000000000000000000000000000000000000000000000000000000000000555555555555555000000000000000000000000000000000000000000000000000
0000000000000000000000000000000000000000000000000000000000000000000000000000000000000000000000555555555555555000000000000000000000000000000000000000000000000000
0000000000000000000000000000000000000000000000000000000000000000000000000000000000000000000000555555555555555000000000000000000000000000000000000000000000000000
0000000000000000000000000000000000000000000000000000000000000000000000000000000000000000000000555555555555555000000000000000000000000000000000000000000000000000
0000000000000000000000000000000000000000000000000000000000000000000000000000000000000000000000555555555555555000000000000000000000000000000000000000000000000000
0000000000000000000000000000000000000000000000000000000000000000000000000000000000000000000000555555555555555000000000000000000000000000000000000000000000000000
0000000000000000000000000000000000000000000000000000000000000000000000000000000000000000000000555555555555555000000000000000000000000000000000000000000000000000
0000000000000000000000000000000000000000000000000000000000000000000000000000000000000000000000555555555555555000000000000000000000000000000000000000000000000000
0000000000000000000000000000000000000000000000000000000000000000000000000000000000000000000000555555555555555000000000000000000000000000000000000000000000000000
0000000000000000000000000000000000000000000000000000000000000000000000000000000000000000000000555555555555555000000000000000000000000000000000000000000000000000
0000000000000000000000000000000000000000000000000000000000000000000000000000000000000000000000555555555555555000000000000000000000000000000000000000000000000000
0000000000000000000000000000000000000000000000000000000000000000000000000000000000000000000000000000000000000000000000000000000000000000000000000000000000000000
0000000000000000000000000000000000000000000000000000000000000000000000000000000000000000000000000000000000000000000000000000000000000000000000000000000000000000
0000000000000000000000000000000000000000000000000000000000000000000000000000000000000000000000000000000000000000000000000000000000000000000000000000000000000000
0000000000000000000000000000000000000000000000000000000000000000000000000000000000000000000000000000000000000000000000000000000000000000000000000000000000000000
0000000000000000000000000000000000000000000000000000000000000000000000000000000000000000000000000000000000000000000000000000000000000000000000000000000000000000
0000000000000000000000000000000000000000000000000000000000000000000000000000000000000000000000000000000000000000000000000000000000000000000000000000000000000000
0000000000000000000000000000000000000000000000000000000000000000000000000000000000000000000000000000000000000000000000000000000000000000000000000000000000000000
0000000000000000000000000000000000000000000000000000000000000000000000000000000000000000000000000000000000000000000000000000000000000000000000000000000000000000
