0000000000000000000000000000000000000000000000000000000000000000000000000000000000000000000000000000000000000000000000000000000000000000000000000000000000000000
0000000000000000000000000000000000000000000000000000000000000000000000000000000000000000000000000000000000000000000000000000000000000000000000000000000000000000
0000000000000000000000000000000000000000000000000000000000000000000000000000000000000000000000000000000000000000000000000000000000000000000000000000000000000000
0000000000000000000000000000000000000000000000000000000000000000000000000000000000000000000000000000000000000000000000000000000000000000000000000000000000000000
0000000000000000000000000000000000000000000000000000000000000000000000000000000000000000000000000000000000000000000000000000000000000000000000000000000000000000
0000000000000000000000000000000000000000000000000000000000000000000000000000000000000000000000000000000000000000000000000000000000000000000000000000000000000000
0000000000000000000000000000000000000000000000000000000000000000000000000000000000000000000000000000000000000000000000000000000000000000000000000000000000000000
0000000000000000000000000000000000000000000000000000000000000000000000000000000000000000000000000000000000000000000000000000000000000000000000000000000000000000
0000000000000000000000000000000000000000000000000000000000000000000000000000000000000000000000000000000000000000000000000000000000000000000000000000000000000000
0000000000000000000000000000000000000000000000000000000000000000000000000000000000000000000000000000000000000000000000000000000000000000000000000000000000000000
0000000000000000000000000000000000000000000000000000000000000000000000000000000000000000000000000000000000000000000000000000000000000000000000000000000000000000
0000000000000000000000000000000000000000000000000000000000000000000000000000000000000000000000000000000000000000000000000000000000000000000000000000000000000000
0000000000000000000000000000000000000000000000000000000000000000000000000000000000000000000000000000000000000000000000000000000000000000000000000000000000000000
0000000000000000000000000000000000000000000000000000000000000000000000000000000000000000000000000000000000000000000000000000000000000000000000000000000000000000
0000000000000000000000000000000000000000000000000000000000000000000000000000000000000000000000000000000000000000000000000000000000000000000000000000000000000000
0000000000000000000000000000000000000000000000000000000000000000000000000000000000000000000000000000000000000000000000000000000000000000000000000000000000000000
0000000000000000000000000000000000000000000000000000000000000000000000000000000000000000000000000000000000000000000000000000000000000000000000000000000000000000
0000000000000000000000000000000000000000000000000000000000000000000000000000000000000000000000000000000000000000000000000000000000000000000000000000000000000000
0000000000000000000000000000000000000000000000000000000000000000000000000000000000000000000000000000000000000000000000000000000000000000000000000000000000000000
0000000000000000000000000000000000000000000000000000000000000000000000000000000000000000000000000000000000000000000000000000000000000000000000000000000000000000
0000000000000000000000000000000000000000000000000000000000000000000000000000000000000000000000000000000000000000000000000000000000000000000000000000000000000000
0000000000000000000000000000000000000000000000000000000000000000000001000000000000000000010000000000000000000000000000000000000000000000000000000000000000000000
0000000000000000000000000000000000000000000000000000000000000000000000000000000000000000000000011111111111111111111000000000000000000000000000000000000000000000
0000000000000000000000000000000000000000000000000000000000000000000000000000000000000000000000011111111111111111111000000000000000000000000000000000000000000000
0000000000000000000000000000000000000000000000000000000000000000000000000000000000000000000000011111111111111111111000000000000000000000000000000000000000000000
0000000000000000000000000000000000000000000000000000000000000000000000000000000000000000000000011111111111111111111000000000000000000000000000000000000000000000
0000000000000000000000000000000000000000000000000000011111111111110000000000000000000000000000011111111111111111111000000000000000000000000000000000000000000000
0000000000000000000000000000000000000000000000000000011111111111110000000000000000000000000000011111111111111111111000000000000000000000000000000000000000000000
0000000000000000000000000000000000000000000000000000011111111111110000000000000000000000000000011111111111111111111000000000000000000000000000000000000000000000
0000000000000000000000000000000000000000000000000000011111111111110000000000000000000000000000011111111111111111111000000000000000000000000000000000000000000000
0000000000000000000000000000000000000000000000000000011111111111110000000000000000000000000000011111111111111111111000000000000000000000000000000000000000000000
0000000000000000000000000000000000000000000000000000011111111111110001000000000000000000010000011111111111111111111000000000000000000000000000000000000000000000
0000000000000000000000000000000000000000000000000000011111111111110000000000000000000000000000011111111111111111111000000000000000000000000000000000000000000000
0000000000000000000000000000000000000000000000000000011111111111110000000000000000000000000000011111111111111111111000000000000000000000000000000000000000000000
0000000000000000000000000000000000000000000000000000011111111111110000000000000000000000000000011111111111111111111000000000000000000000000000000000000000000000
0000000000000000000000000000000000000000000000000000011111111111110000000000000000000000000000011111111111111111111000000000000000000000000000000000000000000000
0000000000000000000000000000000000000000000000000000011111111111110000000000000000000000000000011111111111111111111000000000000000000000000000000000000000000000
0000000000000000000000000000000000000000000000000000011111111111110000000000000000000000000000011111111111111111111000000000000000000000000000000000000000000000
0000000000000000000000000000000000000000000000000000011111111111110000000000000000000000000000011111111111111111111000000000000000000000000000000000000000000000
0000000000000000000000000000000000000000000000000000011111111111110000000000000000000000000000011111111111111111111000000000000000000000000000000000000000000000
0000000000000000000000000000000000000000000000000000011111111111110000000000000000000000000000011111111111111111111000000000000000000000000000000000000000000000
0000000000000000000000000000000000000000000000000000011111111111110001000000000000000000010000011111111111111111111000000000000000000000000000000000000000000000
0000000000000000000000000000000000000000000000000000011111111111110000000000000000000000000000000000000000000000000000000000000000000000000000000000000000000000
0000000000000000000000000000000000000000000000000000011111111111110000000000000000000000000000777777777777777777777700111111111111111111111100000000000000000000
0000000000000000000000000000000000000000000000000000011111111111110000000000000000000000000000777777777777777777777700111111111111111111111100000000000000000000
0000000000000000000000000000000000000000000000000000011111111111110000000000000000000000000000777777777777777777777700111111111111111111111100000000000000000000
0000000000000000000000000000000000000000000000000000011111111111110000000000000000000000000000777777777777777777777700111111111111111111111100000000000000000000
0000000000000000000000000000000000000000000000000000011111111111110000000000000000000000000000777777777777777777777700111111111111111111111100000000000000000000
0000000000000000000000000000000000000000000000000000011111111111110000000000000000000000000000777777777777777777777700111111111111111111111100000000000000000000
0000000000000000000000000000000000000000000000000000011111111111110000000000000000000000000000777777777777777777777700111111111111111111111100000000000000000000
0000000000000000000000000000000000000000000000000000011111111111110000000000000000000000000000777777777777777777777700111111111111111111111100000000000000000000
0000000000000000000000000000000000000000000000000000011111111111110001000000000000000000010000777777777777777777777700111111111111111111111100000000000000000000
0000000000000000000000000000000000000000111111111111111111111111110000000000000000000000000000777777777777777777777700111111111111111111111100000000000000000000
0000000000000000000000000000000000000000111111111111111111111111110000000000000000000000000000777777777777777777777700111111111111111111111100000000000000000000
0000000000000000000000000000000000000000111111111111111111111111110000000000000000000000000000777777777777777777777700111111111111111111111100000000000000000000
0000000000000000000000000000000000000000111111111111111111111111110000000000000000000000000000777777777777777777777700111111111111111111111100000000000000000000
0000000000000000000000000000000000000000111111111111111100000000000000000000000001100000000000777777777777777777777700111111111111111111111100000000000000000000
0000000000000000000000000000000111111110111111111111111101111110000000000000000001100000000000777777777777777777777700111111111111111111111100000000000000000000
0000000000000000000000000000000111111110111111111111111101111110000000000000000001100000000000777777777777777777777700111111111111111111111100000000000000000000
0000000000000000000000000000000111111110111111111111111101111110000000000000000001100000000000777777777777777777777700111111111111111111111100000000000000000000
0000000000000000000000000000000111111110111111111111111101111110000000000000000001100000000000777777777777777777777700111111111111111111111100000000000000000000
0000000000000000000000000000000111111110111111111111111101111110000001000000000000000000010000777777777777777777777700111111111111111111111100000000000000000000
0000000000000000000000000000000111111110111111111111111101111110000000000000000000000000000000777777777777777777777700111111111111111111111100000000000000000000
0000000000000000000000000000000000000000000000000000000000000000000000000000000000000000000000777777777777777777777700111111111111111111111100000000000000000000
0000000000000000000000000000000000000000000000000000000000000000000000000000000000000000000000777777777777777777777700111111111111111111111100000000000000000000
0000000000000000000000000000000000000000000000000000000000000000000000000000000000000000000000000000000000000000000000000000000000000000000000000000000000000000
0000000000000000000000000000000000000000000000000000000000000000000000000000000000000000000000000000000000000000000000000000000000000000000000000000000000000000
0000000000000000000000000000000000000000000000000000000000000000000000000000000000000000000000000000000000000000000000000000000000000000000000000000000000000000
0000000000000000000000000000000000000000000000000000000000000000000000000000000000000000000000000000000000000000000000000000000000000000000000000000000000000000
0000000000000000000001000000000100000000010000000001000000000100000000000000000000000000000000000100000000010000000001000000000100000000010000000000000000000000
0000000000000000000000000000000000000000000000000000000000000000000000000000000000000000000000000000000000000000000000000000000000000000000000000000000000000000
0000000000000000000000000000000000000000000000000000000000000000000000000000000000000000000000000000000111111111100000000000000000000000000000000000000000000000
0000000000000000000000000000000000000000000000000000000111111000000000000000000000000000000000000000000111111111100000000000000000000000000000000000000000000000
0000000000000000000000000000000000000000000000000000000111111000000000000000000000000000000000000000000111111111100000000000000000000000000000000000000000000000
0000000000000000000000000000000000000000000000000000000000000000000000000000000000000000000000000000000000000000000000000000000000000000000000000000000000000000
0000000000000000000000000000000000000000000000000000000000000000000000000000000000000000000000000000000000000000000000000000000000000000000000000000000000000000
0000000000000000000000000000000000000000000000000000000000000000000000000011111100000000000000000000000000000000000000000000000000000000000000000000000000000000
0000000000000000000000000000000000000000000000000000000000000000000000000011111100000000000000000000000000000000000000000000000000000000000000000000000000000000
0000000000000000000000000000000000000000000000000000000000000000000000000011111100000000000000000000000000000000000000000000000000000000000000000000000000000000
0000000000000000000000000000000000000000000000000000000000000000000000000011111100000000000000000000000000000000000000000000000000000000000000000000000000000000
0000000000000000000000000000000000000000000000000000000000000000000000000011111100000000000000000000000111111111111111000000000000000000000000000000000000000000
0000000000000000000000000000000001111000111111000000000000000000000000000000000000000000000000000001111111111111111111000000000000000000000000000000000000000000
0000000000000000000000000000000001111000111111000000000000000000000000000000000000000000000000000001111111111111111111000000000000000000000000000000000000000000
0000000000000000000000000000000000000000111111000000000000000000000000000000000000000000000000000000000111111111111111000000000000000000000000000000000000000000
0000000000000000000000000000000000000000000000000000000000000000000000000000000000000000000000000000000000000000000000000000000000000000000000000000000000000000
0000000000000000000000000000000000000000000000000000000000000000000000000000000000000000000000000000000000000000000000000000000000000000000000000000000000000000
0000000000000000000000000000000000000000000000000000000000000000000000000000000000000000000000000000000000000000000000000000000000000000000000000000000000000000
0000000000000000000000000000000000000000000000000000000000000000000000000000000000000000000000000000000000000000000000000000000000000000000000000000000000000000
0000000000000000000000000000000000000000000000000000000000000000000000000000000000000000000000000000000000000000000000000000000000000000000000000000000000000000
0000000000000000000001000000000100000000010000000001000000000100000000000000000000000000000000000100000000010000000001000000000100000000010000000000000000000000
0000000000000000000000000000000000000000000000000000000000000000000000000000000000000000000000000000000000000000000000000000000000000000000000000000000000000000
0000000000000000000000000000000000000000000000000000000000000000000000000000000000000000000000000000000000000000000000000000000000000000000000000000000000000000
0000000000000000000000000000000000000000000000000000000000000000000000000000000000000000000000000000000000000000000000000000000000000000000000000000000000000000
0000000000000000000000000000000000000000000000000000000000000000000000000000000000000000000000000000000000000000000000000000000000000000000000000000000000000000
0000000000000000000000000000001111111111111111111100111111111111100000000000000000000000000000111111111111111000000000000000000000000000000000000000000000000000
0000000000000000000000000000001111111111111111111100111111111111100000000000000000000000000000111111111111111000000000111111111111110000000000000000000000000000
0000000000000000000000000000001111111111111111111100111111111111100000000000000000000000000000111111111111111000000000111111111111110000000000000000000000000000
0000000000000000000000000000001111111111111111111100111111111111100001000000000000000000010000111111111111111000000000111111111111110000000000000000000000000000
0000000000000000000000000000001111111111111111111100111111111111100000000000000000000000000000111111111111111000000000111111111111110000000000000000000000000000
0000000000000000000000000000001111111111111111111100111111111111100000000000000000000000000000111111111111111000000000111111111111110000000000000000000000000000
0000000000000000000000000000001111111111111111111100111111111111100000000000000000000000000000111111111111111000000000111111111111110000000000000000000000000000
0000000000000000000000000000001111111111111111111100111111111111100000000000000000000000000000111111111111111000000000111111111111110000000000000000000000000000
0000000000000000000000000000001111111111111111111100111111111111100000000000000000000000000000111111111111111000000000111111111111110000000000000000000000000000
0000000000000000000000000000001111111111111111111100111111111111100000000000000000000000000000111111111111111000000000111111111111110000000000000000000000000000
0000000000000000000000000000001111111111111111111100111111111111100000000000000000000000000000111111111111111000000000111111111111110000000000000000000000000000
0000000000000000000000000000001111111111111111111100111111111111100000000000000000000000000000111111111111111000000000111111111111110000000000000000000000000000
0000000000000000000000000000001111111111111111111100111111111111100000000000000000000000000000111111111111111000000000111111111111110000000000000000000000000000
0000000000000000000000000000001111111111111111111100111111111111100001000000000000000000010000111111111111111000000000111111111111110000000000000000000000000000
0000000000000000000000000000001111111111111111111100111111111111100000000000000000000000000000111111111111111000000000111111111111110000000000000000000000000000
0000000000000000000000000000001111111111111111111100111111111111100000000000000000000000000000111111111111111000000000000000000000000000000000000000000000000000
0000000000000000000000000000001111111111111111111100111111111111100000000000000000000000000000111111111111111000000000000000000000000000000000000000000000000000
0000000000000000000000000000001111111111111111111100111111111111100000000000000000000000000000111111111111111000000000000000000000000000000000000000000000000000
0000000000000000000000000000001111111111111111111100111111111111100000000000000000000000000000111111111111111000000000000000000000000000000000000000000000000000
0000000000000000000000000000001111111111111111111100111111111111100000000000000000000000000000111111111111111000000000000000000000000000000000000000000000000000
0000000000000000000000000000001111111111111111111100111111111111100000000000000000000000000000111111111111111000000000000000000000000000000000000000000000000000
0000000000000000000000000000000000000000000000000000111111111111100000000000000000000000000000111111111111111000000000000000000000000000000000000000000000000000
0000000000000000000000000000000000000000000000000000111111111111100000000000000000000000000000111111111111111000000000000000000000000000000000000000000000000000
0000000000000000000000000000000000000000000000000000111111111111100001000000000000000000010000111111111111111000000000000000000000000000000000000000000000000000
0000000000000000000000000000000000000000000000000000111111111111100000000000000000000000000000111111111111111000000000000000000000000000000000000000000000000000
0000000000000000000000000000000000000000000000000000111111111111100000000000000000000000000000111111111111111000000000000000000000000000000000000000000000000000
0000000000000000000000000000000000000000000000000000111111111111100000000000000000000000000000111111111111111000000000000000000000000000000000000000000000000000
0000000000000000000000000000000000000000000000000000111111111111100000000000000000000000000000111111111111111000000000000000000000000000000000000000000000000000
0000000000000000000000000000000000000000000000000000111111111111100000000000000000000000000000111111111111111000000000000000000000000000000000000000000000000000
0000000000000000000000000000000000000000000000000000111111111111100000000000000000000000000000111111111111111000000000000000000000000000000000000000000000000000
0000000000000000000000000000000000000000000000000000111111111111100000000000000000000000000000111111111111111000000000000000000000000000000000000000000000000000
0000000000000000000000000000000000000000000000000000111111111111100000000000000000000000000000111111111111111000000000000000000000000000000000000000000000000000
0000000000000000000000000000000000000000000000000000000000000000000000000000000000000000000000111111111111111000000000000000000000000000000000000000000000000000
0000000000000000000000000000000000000000000000000000000000000000000001000000000000000000010000111111111111111000000000000000000000000000000000000000000000000000
0000000000000000000000000000000000000000000000000000000000000000000000000000000000000000000000111111111111111000000000000000000000000000000000000000000000000000
0000000000000000000000000000000000000000000000000000000000000000000000000000000000000000000000111111111111111000000000000000000000000000000000000000000000000000
0000000000000000000000000000000000000000000000000000000000000000000000000000000000000000000000111111111111111000000000000000000000000000000000000000000000000000
0000000000000000000000000000000000000000000000000000000000000000000000000000000000000000000000111111111111111000000000000000000000000000000000000000000000000000
0000000000000000000000000000000000000000000000000000000000000000000000000000000000000000000000111111111111111000000000000000000000000000000000000000000000000000
0000000000000000000000000000000000000000000000000000000000000000000000000000000000000000000000111111111111111000000000000000000000000000000000000000000000000000
0000000000000000000000000000000000000000000000000000000000000000000000000000000000000000000000111111111111111000000000000000000000000000000000000000000000000000
0000000000000000000000000000000000000000000000000000000000000000000000000000000000000000000000111111111111111000000000000000000000000000000000000000000000000000
0000000000000000000000000000000000000000000000000000000000000000000000000000000000000000000000111111111111111000000000000000000000000000000000000000000000000000
0000000000000000000000000000000000000000000000000000000000000000000001000000000000000000010000111111111111111000000000000000000000000000000000000000000000000000
0000000000000000000000000000000000000000000000000000000000000000000000000000000000000000000000111111111111111000000000000000000000000000000000000000000000000000
0000000000000000000000000000000000000000000000000000000000000000000000000000000000000000000000111111111111111000000000000000000000000000000000000000000000000000
0000000000000000000000000000000000000000000000000000000000000000000000000000000000000000000000111111111111111000000000000000000000000000000000000000000000000000
0000000000000000000000000000000000000000000000000000000000000000000000000000000000000000000000111111111111111000000000000000000000000000000000000000000000000000
0000000000000000000000000000000000000000000000000000000000000000000000000000000000000000000000111111111111111000000000000000000000000000000000000000000000000000
0000000000000000000000000000000000000000000000000000000000000000000000000000000000000000000000111111111111111000000000000000000000000000000000000000000000000000
0000000000000000000000000000000000000000000000000000000000000000000000000000000000000000000000111111111111111000000000000000000000000000000000000000000000000000
0000000000000000000000000000000000000000000000000000000000000000000000000000000000000000000000111111111111111000000000000000000000000000000000000000000000000000
0000000000000000000000000000000000000000000000000000000000000000000000000000000000000000000000111111111111111000000000000000000000000000000000000000000000000000
0000000000000000000000000000000000000000000000000000000000000000000000000000000000000000000000111111111111111000000000000000000000000000000000000000000000000000
0000000000000000000000000000000000000000000000000000000000000000000000000000000000000000000000111111111111111000000000000000000000000000000000000000000000000000
0000000000000000000000000000000000000000000000000000000000000000000000000000000000000000000000111111111111111000000000000000000000000000000000000000000000000000
0000000000000000000000000000000000000000000000000000000000000000000000000000000000000000000000111111111111111000000000000000000000000000000000000000000000000000
0000000000000000000000000000000000000000000000000000000000000000000000000000000000000000000000111111111111111000000000000000000000000000000000000000000000000000
0000000000000000000000000000000000000000000000000000000000000000000000000000000000000000000000000000000000000000000000000000000000000000000000000000000000000000
0000000000000000000000000000000000000000000000000000000000000000000000000000000000000000000000000000000000000000000000000000000000000000000000000000000000000000
0000000000000000000000000000000000000000000000000000000000000000000000000000000000000000000000000000000000000000000000000000000000000000000000000000000000000000
0000000000000000000000000000000000000000000000000000000000000000000000000000000000000000000000000000000000000000000000000000000000000000000000000000000000000000
0000000000000000000000000000000000000000000000000000000000000000000000000000000000000000000000000000000000000000000000000000000000000000000000000000000000000000
0000000000000000000000000000000000000000000000000000000000000000000000000000000000000000000000000000000000000000000000000000000000000000000000000000000000000000
0000000000000000000000000000000000000000000000000000000000000000000000000000000000000000000000000000000000000000000000000000000000000000000000000000000000000000
0000000000000000000000000000000000000000000000000000000000000000000000000000000000000000000000000000000000000000000000000000000000000000000000000000000000000000
